start_octave: 2
┌──┬─┬─┬─┬─┬─┬──┬──┬─┬─┬─┬──┬──┬─┬─┬─┬─┬─┬──┬──┬─┬─┬─┬──┬──┬─┬─┬─┬─┬─┬──┬──┬─┬─┬─┬──┬──┬─┬─┬─┬─┬─┬──┬──┬─┬─┬─┬──┬──┬─┬─┬─┬─┬─┬──┬───┐
│  │ │ │ │ │ │  │  │ │ │ │  │  │ │ │ │ │ │  │  │ │ │ │  │  │ │ │ │ │ │  │  │ │ │ │  │  │ │ │ │ │ │  │  │ │ │ │  │  │ │ │ │ │ │  │   │
│  │ │ │ │ │ │  │  │ │ │ │  │  │ │ │ │ │ │  │  │ │ │ │  │  │ │ │ │ │ │  │  │ │ │ │  │  │ │ │ │ │ │  │  │ │ │ │  │  │ │ │ │ │ │  │   │
│  │ │ │ │ │ │  │  │ │ │ │  │  │ │ │ │ │ │  │  │ │ │ │  │  │ │ │ │ │ │  │  │ │ │ │  │  │ │ │ │ │ │  │  │ │ │ │  │  │ │ │ │ │ │  │   │
│  │ │ │ │ │ │  │  │ │ │ │  │  │ │ │ │ │ │  │  │ │ │ │  │  │ │ │ │ │ │  │  │ │ │ │  │  │ │ │ │ │ │  │  │ │ │ │  │  │ │ │ │ │ │  │   │
│  └┬┘ └┬┘ └┬┘  │  └┬┘ └┬┘  │  └┬┘ └┬┘ └┬┘  │  └┬┘ └┬┘  │  └┬┘ └┬┘ └┬┘  │  └┬┘ └┬┘  │  └┬┘ └┬┘ └┬┘  │  └┬┘ └┬┘  │  └┬┘ └┬┘ └┬┘  │   │
│   │   │   │   │   │   │   │   │   │   │   │   │   │   │   │   │   │   │   │   │   │   │   │   │   │   │   │   │   │   │   │   │   │
│   │   │   │   │   │   │   │   │   │   │   │   │   │   │   │   │   │   │   │   │   │   │   │   │   │   │   │   │   │   │   │   │   │
└───┴───┴───┴───┴───┴───┴───┴───┴───┴───┴───┴───┴───┴───┴───┴───┴───┴───┴───┴───┴───┴───┴───┴───┴───┴───┴───┴───┴───┴───┴───┴───┴───┘
 FA  SOL LA  SI  DO  RE  MI  FA  SOL LA  SI  DO  RE  MI  FA  SOL LA  SI  DO  RE  MI  FA  SOL LA  SI  DO  RE  MI  FA  SOL LA  SI  DO  
│------ 2 ------│------------ 3 ------------│------------ 4 ------------│------------ 5 ------------│------------ 6 ------------│-7-│
