┌──┬─┬─┬─┬──┬──┬─┬─┬─┬─┬─┬──┬──┬─┬─┬─┬──┬──┬─┬─┬─┬─┬─┬──┬──┬─┬─┬─┬──┬──┬─┬─┬─┬─┬─┬──┬──┬─┬─┬─┬──┬──┬─┬─┬─┬─┬─┬──┬──┬─┬─┬─┬──┬──┬─┬─┬─┬─┬─┬──┐
│  │ │ │ │  │  │ │ │ │ │ │  │  │ │ │ │  │  │ │ │ │ │ │  │  │ │ │ │  │  │ │ │ │ │ │  │  │ │ │ │  │  │ │ │ │ │ │  │  │ │ │ │  │  │ │ │ │ │ │  │
│  │ │ │ │  │  │ │ │ │ │ │  │  │ │ │ │  │  │ │ │ │ │ │  │  │ │ │ │  │  │ │ │ │ │ │  │  │ │ │ │  │  │ │ │ │ │ │  │  │ │ │ │  │  │ │ │ │ │ │  │
│  │ │ │ │  │  │ │ │ │ │ │  │  │ │ │ │  │  │ │ │ │ │ │  │  │ │ │ │  │  │ │ │ │ │ │  │  │ │ │ │  │  │ │ │ │ │ │  │  │ │ │ │  │  │ │ │ │ │ │  │
│  │ │ │ │  │  │ │ │ │ │ │  │  │ │ │ │  │  │ │ │ │ │ │  │  │ │ │ │  │  │ │ │ │ │ │  │  │ │ │ │  │  │ │ │ │ │ │  │  │ │ │ │  │  │ │ │ │ │ │  │
│  └┬┘ └┬┘  │  └┬┘ └┬┘ └┬┘  │  └┬┘ └┬┘  │  └┬┘ └┬┘ └┬┘  │  └┬┘ └┬┘  │  └┬┘ └┬┘ └┬┘  │  └┬┘ └┬┘  │  └┬┘ └┬┘ └┬┘  │  └┬┘ └┬┘  │  └┬┘ └┬┘ └┬┘  │
│   │   │   │   │   │   │   │   │   │   │   │   │   │   │   │   │   │   │   │   │   │   │   │   │   │   │   │   │   │   │   │   │   │   │   │
│   │   │   │   │   │   │   │   │   │   │   │   │   │   │   │   │   │   │   │   │   │   │   │   │   │   │   │   │   │   │   │   │   │   │   │
└───┴───┴───┴───┴───┴───┴───┴───┴───┴───┴───┴───┴───┴───┴───┴───┴───┴───┴───┴───┴───┴───┴───┴───┴───┴───┴───┴───┴───┴───┴───┴───┴───┴───┴───┘
 DO  RE  MI  FA  SOL LA  SI  DO  RE  MI  FA  SOL LA  SI  DO  RE  MI  FA  SOL LA  SI  DO  RE  MI  FA  SOL LA  SI  DO  RE  MI  FA  SOL LA  SI  
│------------ 2 ------------│------------ 3 ------------│------------ 4 ------------│------------ 5 ------------│------------ 6 ------------│
